4 4 4 4 4 4 4 4 4 
5 0 0 0 6 0 0 0 6
5 0 0 0 0 0 0 0 6
5 0 0 0 0 0 0 0 6
5 4 0 0 0 0 0 4 6
5 0 0 0 0 0 0 0 6
5 0 0 0 0 0 0 0 6
5 0 0 0 5 0 0 0 6
4 4 4 4 4 4 4 4 4