4 4 4 4 4 4 4 4 4 
4 0 0 0 4 0 0 0 4
4 0 0 0 0 0 0 0 4
4 0 0 0 0 0 0 0 4
4 4 0 0 0 0 0 4 4
4 0 0 0 0 0 0 0 4
4 0 0 0 0 0 0 0 4
4 2 0 0 4 0 0 5 4
4 4 4 4 4 4 4 4 4